20 20
# # # # # # # # # # # # # # # # # # # #
# . # # # # . # # # . . # # # # # # . #
# . . . . . . . # # # # # . # # # . . #
# # # # # . # . . . . . . # # # # # # #
# . . . . . . # # # . # # . . . # . . #
# . # # . . . . . # . # # . # # # # . #
# . . # # . # # # . . # . # . # # # . #
# . # . . . . . . . # # # . # # # # . #
# . . # # # # # # . # # # # . # . . . #
# . # # . . # # # . # # . # # # # # . #
# . . . . . . # . . # . . . . # . . # #
# # # . . # # . # . . # # # . . . # # #
# . # # . # B . . # . . # # # # . # # #
# . . # . . # # . # # . . . . . . . . #
# # # # . . . . . . . # . # . . # # # #
# # . # # # . # . # # # . # . # . # # #
# . . # . # # . . . . . # . . # # . # #
# # . . . # # # # # . # # . . A # # # #
# # . . # . . # # . . . . . # # # . . #
# # # # # # # # # # # # # # # # # # # #